0000000005000000000000000000000000000000000000000000000000000000000000000000000000000000000000000
0000000005000000000000000000000000000000000000000000000000000000000000000000000000000000000000000
0000000005000000000000000000000000000000000000000000000000000000000000000000000000000000000000000
0000000005000000000000000000000000000000000000000000000000000000000000000000000000000000000000000
0000000005000000000000000000000000000000000000000000000000000000000000000000000000000000000000000
0000000005555555555500000000000000000000000000000000000000000000000000000000000000000000000000000
0000000000000000000000000000000000000000000000000000000000000000000000000000000000000000000000000
1111111000555555555550050050005555555555555500000000000000000000000000000000000000000000000000000
1000000000100000000052222222225000000000000500000000000000000000000000000000000000000000000000000
1333333110100000000055555555555000000000000500000000000000000000000000000000000000000000000000000
1111111010100000000000000000000000000000000500000000000000000000000000000000000000000000000000000
0000000010100000000000000000000000000000000525252525252522522522522500000000000000000000500000000
0000000010100000000000000000000000000000000555555555555555555555555500000000000000000000500000000
0000000010100000000000000000000000000000000000000000000000000000000522255550000000000000500000000
0000000010100000000000000000000000000000000000000000000000000000000555550005000000000000500000000
0000000010100000000000000000000000000000000000000000000000000000000000000000000000000000500000000
0000000010500000000000000000000000000000000000000000000000000000000000000000005000000000500000000
0000000050100000001000110011111111111100000000000000000000000000000000000000000000000000500000000
0000000010122222221000000010000000001100100000000000000000000000000000000000000050000000500000000
0000000010122222221000000010000000000100000000000000000000000000001111111110000000000000500000000
0000000010122222222110100010000000000000001110001110000000000000000000000010000000500000500000000
0000000010111111111100000010000000000000000000000000000000000000000111111010000000000000500000000
0000000000000000000000000110000000000000000000000000011000000011110000001000000000000000500000000
0000000000000000000000000010000000000000000000000000000000000000000000001000000000000044100000000
0000000011100111111111111110000000000000000000000000000022222000000000001111111111155144100000000
0000000000000000000000000000000000000000000000000000000000000000000000000000000000000011000000000