00000000000000000000000000000000000000000000000000000000000
00000000000000000000000000000000000000000000000000000000000
00000000000000000000000000000000000000000000000000000000000
00000000000000000000000000000000000000000000000000000000000
00000000000000000000000000000000000000000000000000000000000
00000000000000000000000000000000000000000000000000000000000
00000000000000000000000000220000000000050005000000001000000
11111111000055555555000000000000000020000000000500001000000
00000000000000000000000000000000000000000000000000001000000
00000000000000000000020000000200000000000500000005001000000
00000000000000000000000000000000000000500000000000001000000
00000000000000000000000005000000000000500000500000051000000
00000000000000000000000000500000000000500000005000001440000
00000000000000000000000000055555555555500000000000001441221
00000000000000000000000000000000000000000000000000000111111