1111111111111555555511111111111111111111111111
1111111111111500000500000000000000000000000001
1111111111111500000500000000000000000000000001
1111111111111500000555555555555510000000000001
1111111111111500000511111111111110005555555451
1000000000000000000511111111110000000001111410
1000000000000000110000000000000000000000000100
1000000000000001100000000000000001510000000000
1000000000000005000000001111110000000000000000
1000000000000005000000000001111133333100000000
1111155555225555111000000001111133333111111111
0000000005225000001000000001000133333100000000
0000000005555000001000000001000133333100000000
0000000000000000001222112221000133333100000000
0000000000000000001222222221000133333100000000
0000000000000000001111111111000133333100000000
0000000000000000001111111111000111111100000000